hot=뜨거운,매운
cool=시원한
school=학교
spring=봄
summer=여름
autumn=가을
winter=겨울
Sunday=일요일
Monday=월요일
Tuesday=화요일
Wednesday=수요일
Thursday=목요일
Friday=금요일
Saturday=토요일
January=1월
February=2월
March=3월
April=4월
May=5월
June=6월
July=7월
August=8월
September=9월
October=10월
November=11월
December=12월
boy=소년
girl=소녀
sky=하늘
tiger=호랑이
lion=사자
ant=개미
hulk=헐크
spider=거미
frog=개구리
glasses=안경
Hansong=한송
church=교회
company=회사
house=집
park=공원
soccer=축구
baseball=야구
basketball=농구
son=아들
daughter=딸
eye=눈
ear=귀
mirror=거울
music=음악
gun=총
bullet=총알
game=게임
one=하나
eleven=열하나
fifteen=열다섯
forty=마흔